|||||||||||||||||||||||||||||||||||||
|D      | |       |     |       |A  |
| ||||| | | ||||| | | | ||| ||||||| |
| |     |   | |   | | |     |     | |
| | ||||| ||| | ||  | ||||||  ||| | |
| |       |     |  |  |           | |
| ||||||||| | ||| | | | | ||||||||| |
|           |      |    |           |
|||||||||||||||||||||||||||||||||||||
